#########################
#.......""""""".........#
#.......""""""..........#
#....####""....####.....#
#...#####......##.......#
#.....##................#
#.............""""......#
#.............""""......#
#......................##
#....."""...............#
#.....""".....####......#
#.............####......#
#........####...........#
#........####...."".....#
#................"".....#
#.....####..............#
#.....####....."""......#
#................"""..###
#........"""""..........#
#........"""""..........#
#....####...............#
#....####......####.....#
#.......................#
#.......................#
#########################
