##########
#.."""...#
#.."""...#
#....#...#
#....#...#
#........#
#...#....#
#...#....#
#........#
##########
